angenehm – príjemný
der Baum – strom
Compaqnie – spoločnosť
danach – za tým, potom
einfach – jednoduchý
eintragen – zapísať
die Erstinformation – prvotná informácia
evaluieren – hodnotiť
die Evaluierung – hodnotenie
freundlich – priateľský
zu fünft – po päť
der Gedanke – myšlienka
der Gedankenbaum – Mind-Map
genau – presne
der Inhalt – obsah
inkompetent – nekompetentný
kompetent – kompetentný
kompliziert – komplikovaný
die Länge – dĺžka
langweilig – nudný
das Lehrwerk – učebnica
leicht – ľahký
lustig – veselý
die Meinung – mienka, názor podľa mňa
die Methode – metóda
der Nachbar – sused
die Nachbarin – susedka
der Nachmittag – popoludnie
nötig – nutný
die Organisation – organizácia
perfekt – perfektný
der Plan – plán
planen – plánovať
die Planung – plánovanie
planvoll – premyslený, podľa plánu
die Präsentation – prezentácia
das Prozent – percento
pünktlich – presný na čas
der Referent – referent
das Regal – polička
die Regel – pravidlo
die Runde – kolo
schade – škoda
das Schild – značka, tabuľka
der Schreibblock – poznámkový blok
seltsam – čudný, podivný
sensationell – senzačný
suchen – hľadať
der Teil – časť, diel
unfreundlich – nemilý, nevľúdny
ungenau – nepresný, neprecízny
unhöflich – nezdvorilý
unklar – nejasný
unkorrekt – neférový
unmodern – nemoderný
unpraktisch – nepraktický
unpünktlich – nepresný
die Veranstaltung – podujatie, akcia
das Verbot – zákaz
voll – plný
vorher – predtým
die Vorinformation – vstupná informácia
die Vorlesung – prednáška
vorn – vpredu
der Vorschlag – návrh
der Vortrag – prednáška
Ist das wahr? – Je to pravda?
ziemlich – dosť, značne
zu voll – príliš plný
zu groß – príliš veľký
zustimmen – súhlasiť
zwischen – medzi
