allein – sám
ausgezeichnet – vynikajúci
Bayern – Bavorsko
beschäftigen sich mit etwas – zaoberať sa niečím
beschäftigt sein – byť zaneprázdnený
der Bericht – správa
einmal – raz
fantastisch – fantastický
die Ferien – prázdniny
Was gab es zu sehen? – Čo tam bolo vidieť?
ganz toll – celkom skvelý
den ganzen Tag – celý deň
gegen – proti
gestern – včera
herrlich – nádherný
klasse – prvotriedny, vynikajúci
kochen – variť
der letzte – posledný
der Meister – majster
der Nationalspieler – hráč národného družstva
organisieren – organizovať
prima – príma, výborný
der Regen – dážď
das Rollenspiel – hra s pridelenými úlohami
der Satz – veta
schwimmen – plávať
sehen – vidieť
spitze – výborný
der Stau – dopravná zápcha
stundenlang – celé hodiny
der Supermarkt – supermarket
die Tabelle – tabuľka
toll – báječný
das Turnier – turnaj
die Umfrage – anketa
der Urlaub – dovolenka
von bis – od do
vorgestern – predvčerom
war – bol
das Wasser – voda
das Wetter – počasie
das Wörterbuch – slovník
wunderbar – prekrásny, nádherný
zurück sein – byť späť

