der Appetit – chuť 
aufhören mit etwas – prestať s niečím
der Auftrag – objednávka
das Auge – oko
der Bauch – brucho
das Befinden – zdravotný stav
das Bein – noha
gut, besser, am besten – dobrý, lepší, najlepší
die Beschwerden – ťažkosti
das Bett – posteľ
die Bettruhe – pokoj na lôžku
brechen – zlomiť
deshalb – preto
einhalten – dodržať
den Termin einhalten – dodržať termín
die Empfehlung – odporúčanie
die Erkältung – prechladnutie
erzählen – rozprávať (súvislý príbeh)
essen – jesť
das Fahrrad – bicykel
Was fehlt dir? – Čo ti je? 
das Fieber – horúčka
der Fuß – chodidlo
gestern – včera
gesund – zdravý
gleich, sofort – ihneď
der Hals – krk, hrdlo
die Hand – ruka
hohes Fieber – vysoká horúčka  
der Honig – med
der Husten – kašeľ
der Kopf – hlava
das Krankenhaus – nemocnica
die Krankheit – choroba
krankschreiben – vypísať niekoho
Was ist los? – Čo sa deje?
Was ist mit dir los? – Čo je s tebou?
mehrere – viacerí
messen – merať
die Mitteilung – oznámenie, správa
müde sein – byť unavený
nehmen – vziať
nichts – nič
ein paar – niekoľko
der Ratschlag – rada
die rechte Hand – pravá ruka
der Rücksitz – zadné sedadlo v aute
die Ruhe – pokoj
schlafen – spať
Mir ist schlecht. – Je mi zle.
der Schmerz – bolesť
das Schreiben – list, písanie
der Tee – čaj
die Temperatur – teplota
Mir ist übel. – Je mi zle.
der Unfall – nehoda
verbinden – zaviazať
die Verletzung – poranenie
vereinbaren – dohodnúť
verletzen –  poraniť
verordnen – naordinovať, predpísať
verschreiben – predpísať (liek)
